5 16
|---------------|
|........F......|
|......P.......@|
|...............|
|---------------|
